MMMMMMMMMMMMMMMMMMMMMMMMMMMMMMMM
MTTTDMTTTTTTTTTTTTTTTTTTTTTRVVRM
MTMTRTTTTRRRTTTDTTTMMMMMMMMMTVTM
MTMMMTTDDRRRTTTTTTTMTTTTTTTVRVTM
MTMJTTTTTTDDTRRTRRTMTTTTTTTVRVRM
MTMTTTTTTTTTTTTTTTTMTTTTTTTTRTDM
MTMTTTTTTTTTTTTTTRDMTTTTTTTTTTRM
MTMTTTTTTTTTTTTTTRRMTTTTTTTTTTTM
MTMMMMMMMMMMMMMMMMMMTTTTTTTTTTTM
MTTTTTRTTTTTTTTTTRTDRTTTTTTTTTTM
MTTTTTTRTTTTTTTTTTTRTRTTTTTTTTRM
MTTTTRDRTTTTTTTTTTTTTVRTTTTTTRDM
MTTTTTRTTTTTTTTTTTTTTTTRTTTTTRTM
MTTTTTRTTTTTTTTTTTTTTTTTRRRRRRTM
MTTTTTTTTTTTTTTTTTTTTTTTTTTTTTTM
MMMMMMMMMMMMMMMMMMMMMMMMMMMMMMMM