MMMMMMMMMMMMMMMMMMMMMMMMMMMMMMMM
MTTTTTTTTTTTTTTTTTTTTTTTTTTTTTTM
MTTJTTTTTTTTTTTDTTTTTRTTTTTTTTTM
MTTTTTTTDRDRTTTTTTTTTTTTTTTTTTTM
MTTTTTTTTTDDTRRTRRTTTTTTTTTTTTTM
MTTTTTTTTTTTTTTTTTTTTTTTTTTTTTTM
MTTTTTTTTTTTTTTTTRDRTTTTTTTTTTTM
MTTTTTTTTTTTTTTTTRRRTTTTTTTTTTTM
MMMMMMMMMMMMMMMMMMMMTTTTTTTTTTTM
MTTTTTTTTTTTTTTTTTTTTTTTTTTTTTTM
MTTTTTTTTTTTTTTTTTTTTTTTTTTTTTTM
MTTTTTTTTTTTTTTTTTTTTTTTTTTTTTTM
MTTTTTTTTTTTTTTTTTTTTTTTTTTTTTTM
MTTTTTTTTTTTTTTTTTTTTTTTTTTTTTTM
MTTTTTTTTTTTTTTTTTTTTTTTTTTTTTTM
MMMMMMMMMMMMMMMMMMMMMMMMMMMMMMMM